#################################################################################################
....#.#...#...#.....#.#.......#...........#.....#.....#.#...#.....#.....#...#...#...#.......#...#
###.#.#.#.#.###.###.#.#.###.#.#.#.#######.#.###.#####.#.#.#.#.###.#.###.#.#.###.#.###.#####.#.#.#
#...#...#.....#.#.#.#...#...#.#.#.#.......#.#.#.....#.....#.#.#...#.#.....#.....#.......#.#.#.#.#
#.#######.###.#.#.#.###.#.###.###.#.#.#####.#.#####.#######.#.#.###.#.#######.#######.#.#.#.###.#
#...#...#.#...#.#...#...#...#...#.#.#.......#.#...#...#...#.#.#...#.#.......#...#...#.#...#.....#
###.#.#.#.#.###.###############.#.###########.#.#.###.#.#.#.#.#.###.#######.###.#.#.###########.#
#.....#...#.#...#.......#.....#.#.#...#...#...#.#.#...#.#...#.#.....#.......#.#.#.#.............#
#########.#.#.###.#####.###.###.#.#.#.#.#.#.###.#.#.#.#.#####.#######.#######.#.#.#####.#######.#
#...#...#.#.....#.#...#.#.......#...#...#.#.#...#...#...#.....#.....#...#.......#.....#.....#...#
#.###.#.#.#.#####.###.#.#.#.#####.#######.#.#.###########.#####.###.###.#.#####.###########.#.###
#.#...#...#.#.....#...#.#.#...#.#...#.....#.#.....#.....#.#.....#.#.#...#.....#.#.........#.#...#
#.#.#######.#.#####.#.#.#.###.#.###.#.#####.#####.#.###.#.#.#####.#.#.#######.#.#.#####.###.#####
#...#.......#...#...#...#...#.....#.#.#...#...#.#.....#...#.#...#.#...#.......#...#...#.....#...#
#####.###########.#########.#####.#.#.#.#.###.#.###########.#.#.#.#####.#########.###.#######.#.#
#.....#...#.........#...#.......#...#.#.#.....#.............#.#...#...#.....#...#.#...#.....#.#.#
#.#######.#.#######.#.#.###.###.#####.#.###############.#####.###.#.#.#####.###.#.#.#####.#.#.#.#
#.#.....#.....#.....#.#...#...#.....#.#.#...............#...#...#...#.......#...#...#.....#.#.#.#
#.#.###.#####.#.#####.###.###.#####.#.#.#################.#.###.###########.#.#######.#####.#.#.#
#.#.#...#...#.#.#...#.#.#.....#...#.#.#...#.....#.......#.#.#...#...#.....#.#.#.......#...#...#.#
#.#.#.###.#.#.#.#.#.#.#.#.#######.#.#.###.#.###.#.#####.#.#.#.###.#.#.###.#.#.#.#######.#.###.#.#
#.#.#.....#...#.#.#.#...#...#...#.#.#.#...#.#.....#.......#.#.....#...#...#.#...#.....#.#...#.#.#
#.#.###########.#.#.#######.###.#.#.#.#.###.#######.###################.#############.#.###.#.#.#
#...#.....#.....#.#.#.....#...#...#.#.#.#.......#.....#...#.....#.#...#.#.............#.#...#.#.#
#####.#####.#.###.###.###.###.#.###.#.#.#######.#####.#.#.#.###.#.#.###.#.###########.#.#.###.#.#
#.....#.....#.#.#.#...#...#...#.#...#...#.....#.....#.#.#...#...#.#.....#...#...#...#...#...#.#.#
#.#.#####.###.#.#.#.###.#.#.###.#.#######.#.#######.#.#.#.###.###.###########.#.###.###.###.#.#.#
#.#.#.....#...#.#...#...#.#.....#.#...#...#.....#.#.#...#...#.....#...........#...#...#.#...#.#.#
#.###.#####.###.#####.###.#######.###.#######.#.#.#.#####.###.#####.###.#########.###.#.#######.#
#...#.....#.....#...#.#...#.....#.#...........#...#...#.#...#.#...#...#.#.#...#.....#...........#
###.#####.#######.#.###.###.###.#.#.#.###############.#.###.#.#.#######.#.#.#.#.#######.#########
#...#.....#.......#.#.....#.#...#.#.#.....#.......#...#.....#.#...#.....#.#.#.#.....#...#.#.....#
#.###.#####.#########.#.#.#.#.###.#.#.###.#####.###.#####.#######.###.###.#.#####.#.###.#.#.###.#
#.#.#.#.....#.....#...#.#.#.#.....#.#...#...#.#.......#...#...#.......#...#.......#...#...#.#...#
#.#.#.#.###.#.###.#.###.#.#.#######.###.###.#.#####.#.###.#.#.#.#######.#.#.#########.###.###.#.#
#.#.#...#...#.#.#.#.#.#.#.#.#.....#.#...#...#.......#.#...#.#...#...#...#.#.#...#.....#.#...#.#.#
#.#.#####.###.#.#.#.#.#.###.#.#####.#.###############.#.###.#####.#.#.###.#.#.#.#.#####.###.#.###
#.#.........#.#.#...#.......#...#...#.....#.....#...#.#.#...#.....#...#...#.#.#.#.......#...#...#
#.#######.#.#.#.#.#####.#######.#.#######.#.#.#.#.#.#.#.###.#.###.#########.#.#.#####.###.#####.#
#.......#.#...#.#...#...#...#.#.#.#.....#.#.#.#...#...#.....#...#.....#.......#...#.#.........#.#
#######.#######.###.#.#####.#.#.#.#.#.#.#.###.#####.###########.#######.#########.#.#.#########.#
#.....#.#.......#...#.#.....#...#.#.#.#.#.....#.........#...#.#...#...#...#.....#...#...........#
#.###.#.#.###.###.###.#.#.###.###.#.###.#.#####.#.#####.#.#.#.#.#.#.#.###.#.#.#.###############.#
#.#...#...#.#.#.....#.#.#...#...#.#.#...#.#...#.#.....#...#...#.#...#.....#.#.#...#...#.....#.#.#
#.#########.#.###.###.#.#.#.###.#.###.#####.#.#######.#.###################.#####.#.#.#.###.#.#.#
#.#.......#.#.....#...#.#.#...#.#.#...#.....#.#...#...#.#...#.....#.......#.#.....#.#...#.#.#.#.#
#.#.#####.#.#######.#.###.#####.#.#.###.#####.#.#.#.###.#.#.###.#.#.#####.#.#.#####.#.###.#.#.#.#
#.#.#...#.#...#.#...#.#.........#.#.#.#.#...#...#...#...#.#.#...#...#.....#.#.#.....#.#...#.#...#
#.#.#.#.#.#.#.#.#.#####.#########.#.#.#.#.#.#########.###.#.#.#######.#####.#.#######.#.###.#####
#...#.#.#...#...#.................#.#.#...#...#.#.....#...#...#...#...#.....#.........#.#...#...#
#####.#.###.###########.###########.#.#######.#.#.#####.#########.#.###.#####.#########.#.###.#.#
#.....#...#...............#...#.....#.....#...#.....#...#...#...#...........#...#.....#.#.#...#.#
#.#######.###.#########.#.###.#.#####.###.#.#.#####.###.#.#.###.###.###.###.#####.###.#.#.#.###.#
#...#...#...#.#...#.....#.#...#.#...#...#.#.#.#...#...#...#...#.....#...#...#.....#...#...#...#.#
###.#.#####.#.#.#.#.#####.#.###.###.###.#.###.###.###.#.#####.#######.###.#.#.#####.#.#######.###
#...#...#...#...#.#.#...#...#...#...#.#.#.....#...#...#.#.....#.......#.#.#.#.#...#.#.#.#...#...#
#.#####.#.#######.#.#.#.#####.###.###.#.#######.###.#####.###.#.#######.#.#.#.#.#.#.#.#.#.#.###.#
#.....#...#.......#...#...#...#...#...#...#...#.......#...#.#.#.#...#.....#...#.#.#.#...#.#...#.#
#.###.#####.#####.#######.#.###.#.#.#####.#.###.#.#####.###.#.#.#.#.#.#########.###.#.###.#####.#
#...#.......#...#.......#...#...#.#.......#.....#.#.....#.#...#.#.#.#.....#...#...#.#.#...#...#.#
#.#.#########.#.#######.###.#.###.###############.#.#.###.#####.#.#.#####.#.#.###.#.#.#.###.#.#.#
#.#...#.......#...#...#...#...#.#...#...#...#...#...#.....#.......#.#...#...#.#.....#...#...#...#
#.###.#.#########.#.#####.#####.###.#.#.#.###.#.###########.#######.#.#######.###########.###.###
#.#.#.#...#.....#.#...#.......#.#...#.#.#.....#...#.#...#...#...#...#.......#.#.....#.#...#.#...#
#.#.#.###.#.#####.#.#.#####.#.#.#.###.#.#.#######.#.#.###.###.###.#######.###.#.###.#.#.###.###.#
#.#.#.....#.#.....#.#.#.....#.#...#...#.#.#.......#...#...#...#...#...........#...#.#.#...#...#.#
#.#.###.###.#.#######.#.#####.###.#.#####.#########.###.#####.#.###.#############.#.#.#####.#.#.#
#...#...#.#...#.......#.....#...#.#.....#.#.......#.....#.#...#.#...#...#...#.#...#.....#...#.#.#
#####.###.#####.###########.###.#######.#.#.#####.#######.#.#.#.#.###.#.#.#.#.#.#######.#.###.#.#
#.....#...#.....#.#...#...#...#.#...#...#...#...#...#...#...#...#.....#...#.#.#...#...#.#...#.#.#
#.#####.###.#####.#.#.#.#####.###.#.#.#######.#####.#.#.#.#################.#.###.###.#.###.#.#.#
#...#.....#.....#...#.#.#...#...#.#.....#.....#.......#.#.....#.........#...#...#.....#.#.#.#...#
###.#####.#####.#####.#.#.#####.#.#####.#####.#.#############.#.#########.###.#.#######.#.#.#####
#.#.....#...#.#.....#.#.#.......#.....#...#...#.....#.........#.......#...#...#.....#.....#...#.#
#.#####.###.#.#####.#.#.###.#############.#.#.#.###.###.#.###########.#.###.###.#####.#.###.#.#.#
#...#...............#.#...#.#.....#...#...#.#.#.#...#...#.....#.....#...#...#.........#...#.#.#.#
###.###########.#####.#.###.#.###.#.#.#.###.#.#.#####.#####.#.#.###.#####.###.###########.#.#.#.#
#.#.....#...#...#.....#.........#...#...#...#.#.......#.....#...#...#...#.#.#.#...#...#.#...#.#.#
#.#####.#.#.#.###.#####################.#.###########.###########.###.#.#.#.#.###.#.#.#.#####.#.#
#.....#...#...#.....#.........#...#.....#.........#...#.....#.....#...#...#.#...#.#.#.#...#.#...#
#####.#####.#.#.###.###.#####.#.#.#.###.#########.#####.###.#.#####.#######.###.#.#.#.#.#.#.#####
#...........#.#.#.#...#.....#...#...#...#.....#.#.#.....#...#.#.......#.#.....#.#...#.#.#...#...#
#.###.#########.#.###.#####.#####.#########.#.#.#.#.#####.#.#.#.#####.#.#.#.#.#.###.#.#####.#.###
#.#...#...#...#.#.....#.#...#.....#.........#...#...#...#.#.#...#.....#...#.#.#.....#.......#...#
#.#####.#.###.#.###.###.#.###.#####.###################.#.#.#####.#####.#####.#######.#######.#.#
#...#...#...#.#.#...#...#...#.#.....#...#.......#.#...#.#.#...#...#.....#...#.......#.#...#...#.#
###.#.#####.#.#.###.#.#####.#.#.#######.#.###.#.#.#.#.#.#.###.#.###.#####.#.#######.#.#.#.#.#.#.#
#...#.#...#...#...#...#.....#...#.......#.#...#.#.#.#...#...#...#...#.#...#...#.....#.#.#...#.#.#
#.###.#.#.#######.#####.#########.#####.#.#####.#.#.#####.#.#####.###.#.###.#.#####.#.#.#######.#
#...#...#.....#.#.#.....#...#.....#.....#...#...#...#.....#.#...#.......#.#.#.....#...#.....#...#
#.#.#########.#.#.#.#####.#.#.#######.#####.#.###.#########.#.#.#########.#.#.###.###########.#.#
#.#.....#...#.#.#.#.#...#.#.#...#.....#.....#...#.#.......#...#.....#...#...#.#...#.....#.....#.#
#####.#.#.#.#.#.#.#.#.#.###.#.#.#####.#.#######.#.#######.#########.#.#.#######.###.#.#.#.#####.#
#.....#.#.#.#.#...#...#.......#...#...#.....#...#...#...#...........#.#.....#...#...#.#.#.#...#.#
#.#####.###.#.#.#.#########.#####.#.#####.#.#######.#.#.#############.#####.#.###.###.#.#.#.#.#.#
#.....#.......#.#...........#.....#.......#...........#.............#.....#.......#...#...#.#....
#################################################################################################