xxxxxxxx####xxxxxxxxxxxxxxxx#######x
xxxxxx###..##xxxxxxxxx####x##.....##
xxxxx##.....###########..###.@@@@@.#
xxx###.............##.....##....@@.#
x###....##.........................#
##.....#####.....##...............##
#.....##xxx##...####......####...##x
#....##x####...##xx#......##x#####xx
#....#x##......#xx##.......###xxxxxx
##...###.......####..........######x
x#................................##
x##..@.....................##...@..#
xx#.......#########.......####..@..#
xx#..##...#xxxxxxx##......##x#..@.##
x##.####..#xxx########.....###..@.#x
x#..#xx#..#xx##....######......@..#x
x#..####..#x##.@@@..######.......##x
x#...##...#x#..@@@......##..@...##xx
x#...@@@..#x#...............@..##xxx
x##.......#x#.......##....@@@..##xxx
xx#..##...###......###..........#xxx
xx#..###..##....####x#..........#xxx
xx#..#x#.......##xxx##...@@.....#xxx
xx#..#x#.......######...........##xx
x##..####@@@@@@@##@@@@@@@@@@@@@..##x
x#.....##@@@@@@@@@@@@@@@@@@@@@@...#x
x#.@.@@@@@@@@@@@@@@@@@@@@@@@@@@.@.#x
x#...............##.........###...##
x#...##.........###........##x##...#
##..####........##.........##xx#...#
#...####....................##x##.##
#....##...###.......@........#xx###x
##.......##x##...............#xxxxxx
x##.....##xxx##.........##..##xxxxxx
xx#######xxxxx###############xxxxxxx
xxxxxxxxxxxxxxxxxxxxxxxxxxxxxxxxxxxx