.#######...........#....#
.....#.......######...#..
.....##......#....#..##..
......#......####.#..#...
...#.##.........#.#.....#
...###.....#....#....#..#
....####...###....#..#..#
....#......###..###..#..#
..#######.####..###..####
..#######..###...#...#.#.
...#............##.....#.
.....###...###..#........
#..#####...........#...#.
#..#.......#.......#...##
####......####....##....#
#.......#...#....####.###
.....##............#.....
.....#.............#.....
....#########......#....#