#################################################################################################
....................................#...................................#.......................#
..................................@.#...................................#.......................#
....................................#................####...............#.......................#
....................................#...............##..........................................#
....................................#..................##.......................................#
....................................#...............####........................................#
....................................#...................................#.......................#
....................................#...................................#.......................#
....................................#...................................#.......................#
....................................#...................................#.......................#
....................................#...................................#.......................#
#...........#########################...........#############...........#############...........#
#...............................................#...............................................#
#...............................................#.@.............................................#
#...............................................#...............................................#
#...............................................#.......................#.......................#
#...............................................#.......................#.......................#
#...............................................#.......................#.......................#
#...............................................#.......................#.......................#
#...............................................#.......................#.......................#
#.......................................................................#.......................#
#.......................................................................#.......................#
#.......................................................................#.......................#
#####################...#########################...........#############...........#############
#.......................#...........#.......................#...................................#
#.......................#...........#.......................#...................................#
#.......................#...........#.......................#...................................#
#.......................#...........#.......................#.......................#...........#
#.......................#...........#.......................#.......................#...........#
#.......................#...........#.......................#.......................#...........#
#.......................#...........#.......................#.......................#...........#
#.......................#...........#.......................#.......................#...........#
#.......................#...........#...............................................#...........#
#.......................#...........#...............................................#...........#
#.......................#...........#...............................................#...........#
#...........#...........#...........#...........#############...........#############...........#
#...........#...............................................#...........#.......................#
#...........#...............................................#...........#.......................#
#...........#...............................................#...........#.......................#
#...........#...............................................#...........#.......................#
#...........#...............................................#...........#.......................#
#...........#...............................................#...........#.......................#
#...........#...............................................#...........#.......................#
#...........#...............................................#...........#.......................#
#...........#...............................................#...........#.......................#
#...........#...............................................#...........#.......................#
#...........#...............................................#...........#.......................#
#...........#########################...........#...........#...........#...........#############
#...................................#...........#.......................#.......................#
#...................................#...........#.......................#.......................#
#...................................#...........#.......................#.......................#
#...................................#...........#.......................#.......................#
#...................................#...........#.......................#.......................#
#...................................#...........#.......................#.......................#
#...................................#...........#.......................#.......................#
#...................................#...........#.......................#.......................#
#...................................#...........#...........#...................................#
#...................................#...........#...........#...................................#
#...................................#...........#...........#...................................#
#########################...........#...........#########...#########################...........#
#...................................#...............................................#...........#
#...................................#...........................................................#
#...................................#...........................................................#
#...................................#...........................................................#
#...................................#...............................................#...........#
#...................................#...............................................#...........#
#...................................#...............................................#...........#
#...................................#...............................................#...........#
#...................................#...............................................#...........#
#...................................#...............................................#...........#
#...................................#...............................................#...........#
#...........#########################...#################################...........#...........#
#.......................#...........................................................#...........#
#.......................#...........................................................#...........#
#.......................#...........................................................#...........#
#.......................#...........#...............................................#...........#
#.......................#...........#...............................................#...........#
#.......................#...........#...............................................#...........#
#.......................#...........#...............................................#...........#
#.......................#...........#...............................................#...........#
#.......................#...........#...............................................#...........#
#.......................#...........#...............................................#...........#
#.......................#...........#...............................................#...........#
#############...........#...........#...........#############...........#############...........#
#.......................#...................................#....................................
#.......................#...................................#....................................
#.......................#...................................#....................................
#.......................#...................................#....................................
#.......................#...................................#....................................
#.......................#...................................#....................................
#...........................................................#....................................
#...........................................................#....................................
#...........................................................#....................................
#.@.....................#...................................#..................................@.
#.......................#...................................#....................................
#################################################################################################