#################################################################################################
....................................#...................................#.......................#
....................................#...................................#.......................#
....................................#...................................#.......................#
....................................#...................................#.......................#
....................................#...................................#.......................#
....................................#...................................#.......................#
....................................#...................................#.......................#
....................................#...................................#.......................#
....................................#...................................#.......................#
....................................#...................................#.......................#
....................................#...................................#.......................#
#...........#########################...........#############...........#############...........#
#...............................................#.......................#.......................#
#...............................................#.......................#.......................#
#...............................................#.......................#.......................#
#...............................................#.......................#.......................#
#...............................................#.......................#.......................#
#...............................................#.......................#.......................#
#...............................................#.......................#.......................#
#...............................................#.......................#.......................#
#...............................................#.......................#.......................#
#...............................................#.......................#.......................#
#...............................................#.......................#.......................#
#################################################...........#############...........#############
#.......................#...........#.......................#.......................#...........#
#.......................#...........#.......................#.......................#...........#
#.......................#...........#.......................#.......................#...........#
#.......................#...........#.......................#.......................#...........#
#.......................#...........#.......................#.......................#...........#
#.......................#...........#.......................#.......................#...........#
#.......................#...........#.......................#.......................#...........#
#.......................#...........#.......................#.......................#...........#
#.......................#...........#.......................#.......................#...........#
#.......................#...........#.......................#.......................#...........#
#.......................#...........#.......................#.......................#...........#
#...........#...........#...........#...........#############...........#############...........#
#...........#...............................................#...........#.......................#
#...........#...............................................#...........#.......................#
#...........#...............................................#...........#.......................#
#...........#...............................................#...........#.......................#
#...........#...............................................#...........#.......................#
#...........#...............................................#...........#.......................#
#...........#...............................................#...........#.......................#
#...........#...............................................#...........#.......................#
#...........#...............................................#...........#.......................#
#...........#...............................................#...........#.......................#
#...........#...............................................#...........#.......................#
#...........#########################...........#...........#...........#...........#############
#...................................#...........#.......................#.......................#
#...................................#...........#.......................#.......................#
#...................................#...........#.......................#.......................#
#...................................#...........#.......................#.......................#
#...................................#...........#.......................#.......................#
#...................................#...........#.......................#.......................#
#...................................#...........#.......................#.......................#
#...................................#...........#.......................#.......................#
#...................................#...........#.......................#.......................#
#...................................#...........#.......................#.......................#
#...................................#...........#.......................#.......................#
#########################...........#...........#####################################...........#
#...................................#...............................................#...........#
#...................................#...............................................#...........#
#...................................#...............................................#...........#
#...................................#...............................................#...........#
#...................................#...............................................#...........#
#...................................#...............................................#...........#
#...................................#...............................................#...........#
#...................................#...............................................#...........#
#...................................#...............................................#...........#
#...................................#...............................................#...........#
#...................................#...............................................#...........#
#...........#############################################################...........#...........#
#.......................#...........#...............................................#...........#
#.......................#...........#...............................................#...........#
#.......................#...........#...............................................#...........#
#.......................#...........#...............................................#...........#
#.......................#...........#...............................................#...........#
#.......................#...........#...............................................#...........#
#.......................#...........#...............................................#...........#
#.......................#...........#...............................................#...........#
#.......................#...........#...............................................#...........#
#.......................#...........#...............................................#...........#
#.......................#...........#...............................................#...........#
#############...........#...........#...........#############...........#############...........#
#.......................#...................................#....................................
#.......................#...................................#....................................
#.......................#...................................#....................................
#.......................#...................................#....................................
#.......................#...................................#....................................
#.......................#...................................#....................................
#.......................#...................................#....................................
#.......................#...................................#....................................
#.......................#...................................#....................................
#.......................#...................................#....................................
#.......................#...................................#....................................
#################################################################################################